1111111111111111111111111111111111111111111111111111111111111111111111111111111111111111111111111111111111111111111111111111111111111111111111111111111111111111111111111111111111111111111111111111111111111111111111111111111111111111111111111111
....................................................................................................................................................................................................................................................
....................................................................................................................................................................................................................................................
.........................................................................................................111111111..............................................................1.....1...111111...1....1......1....1....1...111111...11.....1......
......................................................................................C..........................................................................................1...1....1....1...1....1......1....1....1.....11.....1.1....1......
..............................................................................................1111111.....................111111..................................................1.1.....1....1...1....1......1....1....1.....11.....1..1...1......
....................................................................................S..............................................................................................1......1....1...1....1......1....1....1.....11.....1...1..1......
...............................................................................11111111111...............................................C.........................................1......1....1...1....1......1....1....1.....11.....1....1.1......
..........................................................................................................................................................................S........1......111111...111111......11111111111...111111...1.....11......
......................................................C.............1111111111..............................S............S.........11111111111111...................................................................................................
...............................................................11...................................1111111111111111111111111111....................................................................................................................
.....................................S.............................S...............................................................................1111111..........................................................................................
............................................11111111111111111.......................................................................................................................................................................................
.................................S..................................................................................................................................................................................................................
............................1111111111111...........................................................................................................................................................................................................
...............11111111111.........................................................................................................................................1111111..........................................................................
...P................SSSSSSSSSSSSSSSSSSSSSSSSSSSSSSSSSSSSSSSSSSSSSSSSSSSSSSSSSSSSSSSSSSSSSSSSSSSSSSSSSSSSSSSSSSSSSSSSSSSSSSSSSSSSSSSSSSSSSSSSSSSSSSSSSSSSSSSSSSSSSSSSSSS.............................................................................
1111111111111111111111111111111111111111111111111111111111111111111111111111111111111111111111111111111111111111111111111111111111111111111111111111111111111111111111111111111111111111111111111111111111111111111111111111111111111111111111111111