11111111111111111111111111111111
11............................11
1.....U........................1
1..............................1
1..........................U...1
1.......11...........111.......1
1...U...1..............1.......1
1.......1...C..........1.......1
1.......1.........U....1.......1
1.......1..............1.......1
1.......1......................1
1.......1......11......C.......1
1....U.........11......1.......1
1..................U...1.......1
1.......1..............1.......1
1.......1.....C........1.......1
1.......1..............1.......1
1.......1..............1.......1
1.......11............11.......1
1..............................1
1..............P..........U....1
1.......U......................1
11............................11
11111111111111111111111111111111